{"cellDim":{"rows":50,"cols":60},"data":
[[0,0,0,0,0,0,0,0,0,0,0,0,0,0,0,0,0,0,0,0,0,0,0,0,0,205,0,0,0,0,0,0,0,0,0,0,0,0,0,0,0,0,0,0,0,0,0,0,205,205,205,205,205,205,205,205,205,205,205,0],
[205,205,205,205,205,205,205,205,205,205,205,205,205,205,0,205,205,205,205,205,205,205,205,205,205,205,205,205,205,205,205,205,205,205,205,205,205,205,205,205,205,205,205,205,0,0,0,0,205,0,0,0,0,0,0,0,0,0,205,0],
[0,0,0,0,0,0,0,0,0,0,0,0,0,205,0,0,0,0,0,0,0,0,0,0,0,205,0,0,0,0,0,0,0,0,0,0,0,0,0,0,0,0,0,205,205,205,205,205,205,205,205,205,205,205,205,0,0,0,205,0],
[205,205,205,0,205,205,0,205,205,205,205,0,0,205,205,205,205,205,205,205,205,205,205,205,0,205,0,0,0,0,205,205,205,205,205,205,0,205,205,205,205,205,0,0,0,205,0,0,0,205,0,0,0,0,205,205,205,205,205,0],
[205,0,0,0,205,0,0,0,0,0,205,0,0,205,0,0,0,0,0,0,205,0,0,205,0,205,205,205,205,205,205,0,0,0,0,205,0,0,0,205,0,205,205,205,205,205,0,205,0,205,0,0,0,0,0,0,0,0,0,0],
[205,205,205,0,205,205,205,205,205,0,205,205,205,205,0,205,205,205,205,0,205,0,0,205,0,205,0,0,0,0,0,0,0,0,0,205,0,0,205,205,0,0,0,0,0,205,0,205,0,205,0,0,205,205,205,205,205,205,0,0],
[205,0,0,0,0,0,0,0,205,0,0,0,0,0,0,205,0,0,205,0,205,0,0,205,0,205,0,0,0,0,0,0,0,0,0,205,0,0,205,0,0,0,0,0,0,205,0,205,0,205,0,205,205,0,0,0,0,205,0,0],
[205,0,205,205,205,0,0,0,205,0,0,0,0,0,0,205,0,0,205,0,205,0,0,205,0,0,0,205,205,205,205,205,205,0,0,205,205,205,205,0,205,205,205,205,0,205,0,205,0,205,0,205,0,0,205,0,0,205,0,0],
[205,0,205,0,205,205,205,205,205,205,205,205,205,205,205,205,0,0,205,0,205,0,0,205,205,205,205,205,0,0,0,0,205,0,0,205,0,0,205,0,205,0,0,205,0,205,0,205,0,205,0,205,0,0,205,0,0,205,0,0],
[205,0,205,0,0,0,0,0,0,0,0,0,0,205,0,205,0,0,205,0,205,0,0,205,0,0,0,0,0,0,0,0,205,0,0,205,0,0,205,0,205,0,0,205,0,205,0,205,0,205,0,205,0,0,205,0,0,205,0,0],
[205,0,205,0,205,205,205,205,205,205,205,0,0,205,0,205,205,205,205,0,205,0,0,205,0,0,0,0,0,0,205,0,205,0,0,205,205,205,205,0,205,0,0,205,0,205,0,205,0,205,0,205,0,0,205,0,0,205,0,0],
[205,0,205,0,205,0,0,0,0,0,205,0,0,205,0,205,0,0,205,0,205,0,0,205,0,0,0,0,205,0,205,0,205,0,0,205,0,0,0,0,205,0,0,205,205,205,205,205,0,205,0,205,0,0,205,0,0,205,0,0],
[205,0,205,0,205,205,205,205,205,0,205,205,205,205,205,205,0,0,205,0,205,0,205,205,205,205,205,205,205,205,205,205,205,205,205,205,205,205,0,0,205,0,0,205,0,0,205,0,0,205,0,205,0,0,205,0,0,205,0,0],
[205,0,205,0,0,0,0,0,0,0,205,0,0,205,0,205,0,0,0,0,205,0,0,205,0,0,0,0,0,0,0,0,0,0,0,0,0,205,0,0,205,0,0,205,0,0,205,0,205,205,205,205,205,205,205,0,0,205,0,0],
[205,0,205,0,0,0,205,205,205,205,205,0,0,205,0,205,205,205,205,205,205,0,205,205,205,205,205,205,205,205,205,205,205,205,205,205,0,205,0,0,205,0,0,205,205,205,205,0,205,0,0,205,0,0,205,0,0,205,0,0],
[205,0,205,205,205,205,205,0,0,0,0,0,0,205,0,0,0,0,0,0,0,0,0,205,0,0,0,0,0,0,0,0,0,0,0,0,0,0,0,0,205,0,0,205,0,0,205,0,205,0,0,205,0,0,205,0,0,205,0,0],
[205,0,0,0,205,0,0,0,0,0,0,0,0,205,0,0,0,0,0,0,205,205,205,205,205,205,205,205,205,205,205,205,205,205,205,205,205,205,205,205,205,0,0,205,205,205,205,205,205,0,0,205,0,0,205,0,0,205,0,0],
[205,205,205,205,205,205,205,205,205,205,205,205,205,205,205,205,205,205,205,205,205,0,0,205,0,0,0,0,0,0,0,0,0,205,0,0,0,0,205,0,0,0,0,205,0,0,0,0,0,0,0,205,0,0,205,0,0,205,0,0],
[205,0,0,0,0,0,0,0,0,0,205,0,0,205,0,0,0,0,0,0,0,0,0,205,0,0,0,0,0,0,0,0,0,205,0,0,0,0,205,0,0,0,0,205,0,0,0,0,0,0,0,205,0,0,205,0,0,205,0,0],
[205,205,205,205,205,205,0,0,0,0,205,0,0,205,0,0,0,205,205,205,205,205,205,205,205,205,205,205,205,205,205,205,205,205,205,205,205,205,205,205,205,205,205,205,0,205,205,205,205,205,205,205,0,0,205,0,0,205,0,0],
[0,0,0,0,0,205,205,205,205,205,205,205,205,205,205,205,205,205,0,0,0,0,0,205,0,0,0,0,0,205,0,0,0,205,0,0,0,0,0,0,0,0,0,0,0,205,0,0,0,0,0,0,0,0,205,0,0,205,0,0],
[0,0,0,0,0,0,0,0,0,0,0,0,0,0,0,0,0,0,0,0,0,0,0,205,0,0,0,0,0,205,0,0,0,205,0,0,0,0,0,0,0,0,205,205,205,205,0,0,0,0,0,0,0,205,205,0,0,205,0,0],
[205,205,205,205,205,205,205,205,205,205,205,205,205,205,205,205,205,205,205,205,205,205,205,205,205,205,205,205,205,205,205,205,205,205,205,205,205,205,205,205,205,205,205,0,0,0,0,0,205,205,205,205,0,205,0,0,0,205,205,205],
[205,0,0,0,0,205,0,0,0,205,0,0,0,0,0,0,0,0,0,0,0,0,0,205,0,0,0,0,0,0,0,0,0,205,0,0,0,0,0,0,0,0,0,0,0,0,0,0,205,0,0,205,0,205,0,0,0,205,0,0],
[205,0,0,0,0,205,0,0,0,205,0,205,205,205,205,205,205,205,205,205,205,205,205,205,205,205,205,205,0,0,0,0,0,205,0,0,0,0,0,0,0,205,0,0,0,0,0,205,205,0,0,205,205,205,205,205,205,205,205,0],
[205,0,0,0,0,205,0,0,0,205,0,205,0,0,0,205,0,205,0,0,205,0,0,205,0,0,0,205,0,0,0,0,0,205,0,0,0,0,0,0,0,205,205,205,205,205,205,205,0,0,0,205,0,205,0,0,0,205,0,0],
[205,205,205,205,205,205,205,205,205,205,0,205,0,0,0,205,0,205,0,0,205,0,0,205,0,0,0,205,205,205,205,205,205,205,205,205,205,205,205,0,0,205,0,0,0,0,0,0,0,0,0,205,0,205,0,0,0,205,0,0],
[205,0,0,0,0,205,0,205,0,205,0,205,0,0,0,205,0,205,0,0,205,0,0,205,0,0,0,205,0,0,0,0,0,205,0,0,0,0,205,205,0,205,0,0,0,0,0,0,0,0,0,205,0,205,0,0,0,205,0,0],
[205,0,0,0,0,205,0,205,0,205,0,205,0,205,205,205,205,205,205,205,205,0,0,205,0,0,0,205,0,0,0,205,205,205,205,205,0,0,0,205,0,205,0,0,205,205,205,205,205,205,205,205,0,205,0,0,0,205,0,0],
[205,0,0,0,0,205,0,205,0,205,0,205,0,0,0,0,0,205,0,0,205,0,0,205,205,205,205,205,0,0,0,205,0,0,0,205,0,205,0,205,0,205,0,0,205,0,0,0,0,0,0,0,0,205,0,0,0,205,0,0],
[205,0,0,205,0,205,0,205,0,205,0,205,205,205,205,205,205,205,0,0,205,0,0,205,0,0,205,0,0,0,0,205,0,0,0,205,0,205,0,205,0,205,0,0,205,0,0,0,0,0,0,0,205,205,0,0,0,205,0,0],
[205,0,0,205,0,205,0,205,0,205,0,205,0,0,0,0,0,205,0,0,205,0,0,205,0,0,205,0,0,0,0,205,0,0,0,205,0,205,0,205,0,205,0,205,205,205,205,205,205,205,205,205,205,0,0,0,0,205,0,205],
[205,205,205,205,0,205,0,205,0,205,0,205,0,0,0,0,0,0,0,0,205,0,0,205,205,205,205,205,205,205,205,205,0,0,205,205,0,205,0,205,0,205,0,205,0,0,0,0,0,0,0,0,0,0,0,0,0,205,0,205],
[205,0,0,205,0,205,0,205,0,205,0,205,205,205,205,205,205,205,205,205,205,205,205,205,0,0,205,0,0,205,0,205,205,205,205,0,0,205,0,205,205,205,205,205,205,205,205,205,205,205,205,205,205,205,205,205,205,205,0,205],
[205,0,0,205,0,205,0,205,0,205,0,205,0,0,205,0,0,205,0,0,205,0,0,205,205,205,205,205,0,205,0,205,0,0,205,0,0,205,0,0,0,0,0,0,0,0,0,0,205,0,0,0,0,0,0,0,0,205,0,205],
[205,0,0,205,0,205,0,205,0,205,0,205,205,0,205,0,0,205,0,0,205,0,0,205,0,0,0,205,0,205,0,205,0,0,205,0,0,205,205,205,205,205,205,205,205,205,205,205,205,205,205,205,205,205,205,205,205,205,0,205],
[205,0,0,205,0,205,0,205,0,205,0,0,205,0,205,0,0,205,0,0,205,0,0,205,0,0,0,205,0,205,0,205,0,0,205,0,0,205,0,0,205,0,0,0,0,0,0,0,205,0,0,0,0,0,0,0,0,205,0,205],
[205,0,0,205,0,205,205,205,205,205,0,0,205,0,205,0,0,205,205,205,205,205,205,205,205,0,0,205,0,205,0,205,0,0,205,0,0,205,205,205,205,205,205,205,205,205,205,205,205,205,205,205,205,205,205,205,205,205,0,205],
[205,205,205,205,0,205,0,205,0,205,0,0,205,0,205,205,205,205,0,0,0,0,0,0,205,0,0,205,0,205,0,205,0,0,205,0,0,0,0,0,205,0,0,0,0,0,0,0,205,0,0,0,0,0,0,0,0,205,0,205],
[205,0,0,205,0,205,0,205,0,205,0,0,205,0,0,0,0,0,0,0,0,0,0,0,205,0,0,205,0,205,0,205,0,0,205,205,205,205,205,205,205,205,205,205,205,205,205,205,205,205,205,205,205,205,205,205,205,205,0,205],
[205,0,0,205,0,205,0,205,0,205,0,0,205,0,0,0,0,0,0,0,0,0,0,205,205,0,0,205,0,205,0,205,0,0,0,0,0,0,0,0,205,0,0,0,0,0,0,0,205,0,0,0,0,0,0,0,0,205,0,205],
[205,0,0,205,0,205,0,205,0,205,0,0,205,0,0,205,205,205,205,205,205,205,205,205,0,0,0,205,0,205,0,205,205,205,205,205,205,205,205,205,205,205,205,205,205,205,205,205,205,205,205,205,205,205,205,205,205,205,0,205],
[205,0,0,0,0,205,0,205,0,205,0,0,205,205,205,205,0,0,0,0,0,0,0,0,0,0,0,205,0,205,0,0,205,0,0,0,205,0,0,0,205,0,0,0,0,0,0,0,205,0,0,0,0,0,0,0,205,0,0,205],
[205,205,205,205,205,205,0,205,0,205,0,0,0,0,0,0,0,0,0,0,0,0,0,0,0,0,0,205,0,205,0,0,205,0,0,0,205,205,205,205,205,205,205,205,0,0,0,0,205,0,0,0,0,0,0,0,205,205,205,205],
[205,0,0,0,0,205,0,205,0,205,205,205,205,205,205,205,205,205,205,205,205,205,205,205,205,205,205,205,0,205,205,205,205,205,205,205,205,0,0,0,205,0,0,205,205,205,205,205,205,205,205,205,205,205,205,205,205,0,0,205],
[205,0,0,0,0,205,0,205,0,0,0,0,0,0,0,0,0,0,0,0,0,0,0,0,0,0,0,0,0,0,0,0,0,0,0,0,205,0,0,0,205,0,0,0,0,0,0,0,0,0,0,0,0,0,0,0,205,0,0,205],
[205,0,0,0,0,205,0,205,205,205,205,205,205,205,205,205,205,205,205,205,205,205,205,205,205,205,205,205,205,205,205,205,205,205,0,0,205,0,0,0,205,0,0,0,0,0,0,0,0,0,0,0,205,205,205,205,205,0,0,205],
[205,0,0,0,0,205,0,205,0,0,0,0,0,0,0,0,0,0,0,0,0,0,0,0,0,0,0,0,0,0,0,0,0,0,205,205,205,205,205,205,205,205,205,205,205,205,205,205,205,205,205,205,205,0,0,0,205,0,0,205],
[205,0,0,0,0,205,0,205,205,205,205,205,205,205,205,205,205,205,0,0,0,0,0,0,0,0,0,0,0,0,0,0,0,0,0,0,0,0,0,0,0,0,0,0,0,0,0,0,0,0,0,0,0,0,0,0,205,0,0,205],
[205,205,205,205,205,205,205,205,0,0,0,0,0,0,0,0,0,205,205,205,205,205,205,205,205,205,205,205,205,205,205,205,205,205,205,205,205,205,205,205,205,205,205,205,205,205,205,205,205,205,205,205,205,205,205,205,205,205,205,205]]}